444444444444444444444444444444444444444444444444444444444444444444444444444444444444444444444444444444444444444444444444444444
400000000000000000000000000000000000000000000000000000000000000000000000000000000000000000000000000000000000000000000000000004
400000000000000000000000000000000000000000000000000000000000000000000000000000000000000000000000000000000000000000000000000004
400000000000000000000000000000000000000000000000000000000000000000000000000000000000000000000000000000000000000000000000000004
400000000000000000000000000000000000000000000000000000000000000000000000000000000000000000000000000000000000000000000000000004
400000000000000000000000000000000000000022222222222000000000000000000000000000000000000000000000000000000000000000000000000004
400000000000000000000000000000000000000011111111111000000000000000000000000022220000000000000000000000000000000000000000000004
400000000000000000000000000000000000000000000000000000000000000000000000000000002222000000000000000000000000000000000000000004
400000000000000000000000000000000000000000000000000000000000000000000000000000002222222222222222222222000000000000000000000004
400000000000000000000000000000000000000000000000000000000000000000000000000000000000000000000000000000000000000000000000000004
400000000000000000000000000000000000000000000000000000000000000000000000000000000000000000000000000000000000000000000000000004
400000000000000000000000000000000000000000000000000000000000000000000000000000000000000000000000000000000000000000000000000004
400000000000000000000000000000000000000000000000000000000000000000000000000000000000000000000000000000000000000000000000000004
400000000000000000000000000000000000000000000000000000000000000000000000000000000000000000000000000020000000000000000000000004
400000002222220000000000000000000000000000000000000000000000000000000000000000000000000000000000000020000000000000000000000004
400000000000000000000000000000000000000000000000000000000000000000000000000000000000000000000000000020000000000000000000000004
400000000000000000000000000000000000000000000000000000000000000000000000000000000000000000000000000020000000000000000000000004
400000000000000000000000000000000000000000000000000000000000000000000000000000000000000000000000000020000000000000000000000004
422000000000000000220000022220000000000000000000000000000000000000000000000000000000000000000000000020000000000000000000000004
411222222222222222110000221120000000000002222220000000000000000000000000000000000000000000000000000020000000000000000000000004
411111111111111111110000111110002222222222111120000000000000000000000000000000000000000000222222222220000000000000000000000004
411111111111111111110000011000001111111111111110000000000000000000000000000000000000000000211111111120000000000000000000000004
411111111111111111110000010000000000000000000000000000000000000000000000000000000222222222211111111120000000000000000000000004
411111111111111111110000010000000000000000000000000000000000000000000000000000000111111111110000000000000000000000000000000004
411111111111111111110000000000000000000000000000000000000000000000000000000000000000000000000000000000000000000000000000000004
411111111111111111110000000000000000000000000000000000000000000000000000000000000000000000000000000000000000000000000000000004
411111111111111111110000000000000000000000000000000000000000000000000000000000000000000000000000000000000000000000000000000004
411111111111111111110000000000000000000000000000000000000000000000000000000000000000000000000000000000000000000000000000000004
400000000000000000000000000000000000000000000000000000000000000222222222222000000000000000000000000000000000000000000000000004
400000000000000000000000000000000000000000000000000000000000000000000000000000000000000000000000000000000000000000000000000004
400000000000000000000000000000000000000000000000000222222222222200000000000000000000000000000000000000000000000000000000000004
400000000000000000000000000000000000000000000000000000000000000000000000000000000000000000000000000000000000000000000000000004
400000000000000000000000000000000000000000000000000000000000000000000000000000000000000000000000000000000000000000000000000004
400000000000000000000000000000000000002222222220000000000000000000000000000000000000000000000000000000000000000000000000000004
400000000000000000000000000000000000000000000000000000000000000000000000000022222222222200000000000000000000000000000000000004
400000000000000000000000000000000000000000000000000000000000002222222222222200000000002200000000000000000000000000000000000004
400000000000000000000002222222222222220000000000000000000000000000000000000000000000002200000000000000000000000000000000000004
400000000000000000000000000000000000000000000000000000000000000000000000000000000000002222222222222222222200000000000000000004
400000000000000000000000000000000000000000000000000000000000000000000000000000000000000000000000000000000000000000000000000004
400000002200000000000000000000000000000000000000000000000022000000000000000000000000000000000000000000000000000000000000000004
400000002200000000000000000000000000000000000000000000000022000000000000000000000000000000000000000000000000000000000000000004
400000002200000000000000000000000000000000000000000000000022000000000000000000000000000000000000000000000000000000000000000004
422222222222222222222222222222222222222222222222222222222222222222222222222222222222222222222222222222222222222222222222222224
411111111111111111111111111111111111111111111111111111111111111111111111111111111111111111111111111111111111111111111111111114
411111111111111111111111111111111111111111111111111111111111111111111111111111111111111111111111111111111111111111111111111114
444444444444444444444444444444444444444444444444444444444444444444444444444444444444444444444444444444444444444444444444444444
